5 5 2
1 1 0 1 1
1 0 0 0 1
1 1 1 0 1
1 0 0 0 0
1 1 1 1 1
e
2 0 u
4 3 r