6 6 2
1 1 0 1 1 1
1 0 0 0 0 1
1 0 0 0 0 0
1 0 1 1 1 1
1 0 0 0 0 1
1 1 1 1 1 1
e
5 2 r
2 0 u