6 6 2
1 1 0 1 1 1
1 0 0 0 0 1
0 0 0 0 0 1
1 1 1 1 0 1
1 0 0 0 0 1
1 1 1 1 1 1
e
0 2 l
2 0 u