5 5 2
1 1 1 0 1
1 0 0 0 1
1 0 1 1 1
1 0 0 0 1
1 0 1 1 1
e
3 0 u
1 4 d