6 5 2
1 1 1 1 1 1
1 0 0 0 0 1
1 0 0 0 0 1
0 0 0 0 0 0
1 1 1 1 1 1
e
0 3 l
5 3 r