6 6 2
1 1 1 1 1 1
1 0 0 0 0 1
1 0 0 1 1 1
1 1 0 0 0 1
0 0 0 0 0 0
1 1 1 1 1 1
e
0 4 l
5 4 r