6 5 1
1 1 1 1 1 1
1 0 0 0 0 1
1 0 0 0 0 1
1 0 0 0 0 0
1 1 1 1 1 1
e 
5 3 r